{
  "id": "level01",
  "next_level": "level02", 
  "tileset": "test2_tiles.png",
  "tile_size": 32,
  "width": 80,
  "height": 22,
  "layers": {
    "ground": [
        [4, 5, 5, 6, 5, 5, 6, 6, 6, 5, 5, 5, 6, 5, 5, 6, 6, 6, 5, 5,
        5, 6, 5, 5, 6, 6, 6, 5, 5, 5, 6, 5, 5, 6, 6, 5, 5, 6, 5, 5,
        6, 6, 6, 5, 5, 5, 6, 5, 5, 6, 6, 6, 5, 5, 5, 6, 5, 5, 6, 6,
        6, 5, 5, 5, 6, 5, 5, 6, 6, 6, 5, 5, 5, 5, 5, 5, 5, 6, 6, 7],

        [8, 3, 2, 2, 1, 1, 3, 3, 3, 1, 1, 2, 3, 1, 3, 1, 2, 1, 2, 1,
        2, 3, 1, 1, 2, 1, 1, 1, 1, 2, 3, 3, 3, 1, 3, 3, 1, 2, 2, 2,
        2, 2, 2, 3, 2, 1, 3, 1, 3, 2, 3, 2, 2, 3, 3, 3, 1, 1, 1, 3,
        3, 2, 3, 2, 3, 3, 2, 2, 3, 3, 3, 1, 1, 1, 3, 1, 2, 2, 3, 11],

        [8, 3, 3, 2, 3, 2, 2, 1, 1, 2, 3, 2, 2, 2, 3, 2, 3, 2, 2, 1,
        1, 1, 2, 1, 1, 2, 2, 1, 2, 1, 2, 2, 3, 2, 2, 3, 1, 3, 1, 1,
        1, 3, 2, 2, 1, 3, 2, 2, 3, 3, 1, 3, 1, 1, 1, 1, 1, 3, 3, 2,
        1, 2, 3, 1, 1, 3, 1, 3, 1, 3, 1, 1, 3, 1, 1, 3, 3, 2, 2, 11],

        [8, 2, 3, 2, 2, 1, 3, 3, 1, 3, 3, 3, 2, 3, 2, 2, 1, 1, 1, 3,
        2, 1, 2, 1, 1, 2, 2, 1, 1, 3, 1, 1, 3, 3, 3, 1, 1, 1, 2, 3,
        1, 3, 3, 2, 2, 1, 3, 2, 1, 2, 3, 3, 1, 1, 2, 2, 1, 2, 1, 1,
        1, 3, 2, 3, 3, 2, 3, 2, 1, 3, 1, 3, 2, 3, 1, 3, 1, 3, 2, 11],

        [8, 2, 3, 3, 1, 3, 1, 1, 1, 2, 1, 1, 3, 3, 2, 3, 2, 3, 1, 2,
        1, 2, 2, 3, 1, 2, 3, 1, 2, 2, 3, 3, 1, 3, 2, 2, 2, 2, 2, 2,
        3, 2, 2, 1, 2, 3, 3, 2, 3, 2, 2, 3, 2, 1, 2, 1, 2, 2, 2, 3,
        2, 3, 2, 2, 1, 1, 1, 1, 1, 1, 2, 3, 3, 1, 1, 3, 2, 1, 3, 11],

        [8, 2, 1, 3, 3, 1, 2, 1, 1, 2, 3, 2, 1, 1, 2, 1, 2, 2, 3, 1,
        2, 1, 1, 3, 3, 1, 3, 1, 1, 3, 3, 1, 2, 1, 2, 2, 1, 1, 3, 1,
        1, 3, 2, 1, 3, 1, 3, 1, 3, 1, 2, 3, 3, 2, 3, 3, 2, 2, 2, 1,
        2, 2, 1, 1, 2, 2, 3, 1, 1, 2, 2, 1, 2, 1, 2, 1, 2, 2, 2, 11],

        [8, 2, 1, 2, 1, 3, 2, 2, 1, 2, 1, 1, 3, 3, 1, 3, 1, 1, 1, 2,
        3, 1, 1, 2, 3, 2, 3, 3, 1, 2, 1, 2, 3, 1, 1, 2, 2, 1, 2, 3,
        1, 1, 3, 1, 1, 3, 2, 3, 2, 3, 2, 3, 3, 1, 2, 1, 3, 1, 1, 1,
        2, 2, 2, 2, 2, 1, 2, 3, 2, 3, 2, 3, 3, 3, 3, 3, 3, 1, 1, 11],

        [8, 1, 2, 2, 3, 2, 3, 1, 3, 3, 3, 3, 3, 1, 3, 1, 3, 2, 2, 3,
        3, 1, 3, 1, 1, 2, 1, 3, 3, 3, 3, 1, 2, 3, 1, 2, 3, 1, 3, 1,
        1, 3, 2, 2, 1, 2, 2, 1, 3, 2, 3, 3, 1, 1, 2, 2, 3, 1, 1, 2,
        2, 1, 2, 2, 3, 2, 1, 3, 3, 3, 3, 1, 3, 1, 1, 1, 3, 3, 1, 11],

        [8, 1, 2, 1, 3, 1, 1, 1, 1, 2, 2, 2, 2, 1, 2, 2, 3, 2, 1, 2,
        1, 2, 1, 1, 2, 3, 1, 3, 1, 3, 2, 2, 3, 2, 2, 1, 2, 1, 3, 2,
        1, 2, 2, 1, 1, 1, 2, 3, 3, 3, 1, 1, 3, 1, 2, 3, 2, 1, 2, 3,
        3, 1, 1, 2, 1, 1, 2, 2, 3, 3, 3, 1, 1, 2, 2, 3, 2, 3, 1, 11],

        [8, 3, 2, 3, 3, 3, 1, 1, 2, 1, 3, 3, 1, 2, 2, 3, 1, 3, 3, 3,
        2, 3, 2, 2, 3, 2, 2, 1, 3, 3, 3, 3, 3, 2, 1, 2, 1, 3, 2, 3,
        2, 1, 3, 3, 2, 2, 1, 2, 1, 3, 1, 1, 1, 2, 3, 2, 1, 2, 2, 1,
        3, 3, 2, 1, 3, 1, 1, 2, 2, 3, 3, 3, 1, 1, 2, 1, 3, 3, 1, 11],

        [8, 2, 1, 3, 2, 3, 1, 3, 3, 3, 1, 1, 1, 2, 1, 1, 2, 2, 3, 1,
        1, 1, 2, 1, 1, 1, 1, 2, 2, 3, 3, 2, 3, 2, 2, 1, 1, 3, 2, 1,
        2, 1, 2, 1, 1, 2, 3, 1, 2, 3, 3, 3, 1, 1, 2, 1, 3, 3, 3, 1,
        1, 2, 2, 3, 3, 3, 3, 1, 3, 1, 3, 2, 1, 3, 1, 1, 1, 2, 1, 11],

        [8, 3, 3, 1, 3, 3, 1, 1, 2, 3, 3, 2, 3, 2, 3, 1, 3, 3, 1, 1,
        3, 2, 2, 3, 1, 2, 2, 2, 1, 3, 2, 2, 1, 3, 3, 1, 3, 2, 2, 1,
        1, 1, 1, 3, 1, 3, 1, 3, 2, 1, 3, 1, 2, 3, 1, 3, 3, 1, 3, 2,
        2, 3, 1, 1, 3, 3, 1, 1, 3, 3, 3, 3, 3, 2, 1, 3, 3, 3, 3, 11],

        [8, 1, 2, 3, 1, 1, 2, 1, 2, 2, 1, 2, 3, 3, 3, 2, 2, 3, 3, 2,
        3, 3, 2, 2, 2, 3, 1, 1, 2, 3, 2, 1, 2, 1, 2, 1, 2, 3, 1, 2,
        2, 1, 1, 3, 1, 3, 1, 2, 2, 1, 1, 3, 1, 2, 1, 3, 3, 3, 1, 2,
        1, 1, 3, 2, 3, 3, 3, 1, 1, 3, 1, 1, 3, 3, 3, 1, 3, 1, 3, 11],

        [8, 3, 2, 2, 1, 3, 3, 1, 1, 3, 2, 2, 3, 3, 3, 1, 3, 2, 3, 1,
        1, 3, 3, 1, 1, 2, 3, 1, 2, 1, 3, 3, 2, 3, 1, 3, 2, 1, 3, 3,
        3, 2, 2, 1, 3, 1, 3, 2, 2, 2, 3, 3, 3, 1, 3, 1, 3, 2, 2, 2,
        3, 2, 3, 3, 2, 3, 1, 3, 1, 3, 2, 2, 3, 3, 1, 3, 1, 3, 2, 11],

        [8, 2, 2, 3, 3, 1, 3, 3, 1, 3, 1, 2, 3, 3, 1, 3, 2, 2, 1, 1,
        3, 3, 3, 1, 2, 3, 2, 2, 2, 1, 3, 1, 3, 1, 1, 2, 2, 1, 2, 3,
        1, 3, 3, 2, 1, 2, 1, 1, 1, 1, 2, 2, 1, 3, 3, 3, 3, 1, 2, 2,
        2, 3, 3, 3, 3, 3, 3, 2, 3, 2, 2, 3, 2, 1, 1, 3, 1, 1, 1, 11],

        [8, 1, 2, 2, 2, 3, 3, 2, 3, 2, 3, 2, 3, 2, 2, 2, 3, 1, 3, 1,
        1, 2, 3, 1, 1, 1, 2, 1, 2, 1, 1, 1, 3, 3, 2, 2, 2, 3, 2, 1,
        3, 2, 1, 3, 1, 1, 2, 3, 2, 2, 3, 2, 2, 2, 2, 1, 3, 3, 1, 3,
        1, 1, 2, 3, 2, 2, 3, 2, 3, 3, 1, 2, 1, 2, 3, 2, 3, 2, 1, 11],

        [8, 3, 1, 2, 2, 2, 3, 3, 3, 2, 3, 2, 3, 3, 1, 2, 3, 2, 2, 2,
        2, 2, 1, 1, 1, 2, 2, 1, 1, 3, 2, 3, 3, 2, 2, 2, 3, 1, 1, 2,
        1, 1, 3, 3, 2, 3, 1, 3, 1, 3, 2, 1, 3, 1, 3, 2, 1, 1, 1, 2,
        1, 2, 3, 1, 2, 2, 3, 1, 1, 1, 3, 1, 1, 1, 3, 1, 1, 2, 1, 11],

        [8, 1, 1, 1, 2, 2, 2, 1, 1, 1, 3, 2, 3, 3, 1, 3, 3, 1, 3, 3,
        1, 1, 3, 3, 1, 2, 2, 1, 2, 3, 3, 3, 1, 1, 1, 2, 1, 1, 1, 2,
        2, 3, 3, 1, 1, 1, 3, 3, 3, 3, 2, 3, 3, 3, 2, 3, 1, 2, 1, 3,
        2, 1, 1, 2, 2, 1, 3, 2, 3, 3, 3, 1, 3, 1, 3, 1, 2, 1, 3, 11],

        [8, 1, 2, 3, 2, 3, 2, 3, 2, 2, 1, 2, 3, 2, 1, 2, 3, 3, 3, 2,
        1, 3, 2, 1, 3, 2, 2, 3, 3, 1, 3, 1, 3, 2, 1, 3, 1, 3, 2, 1,
        2, 3, 1, 1, 2, 2, 3, 2, 2, 2, 2, 2, 3, 1, 3, 1, 1, 2, 3, 1,
        2, 2, 1, 1, 3, 2, 2, 1, 3, 3, 2, 2, 1, 1, 1, 1, 2, 1, 2, 11],

        [8, 1, 2, 3, 2, 3, 2, 3, 2, 2, 1, 2, 3, 2, 1, 2, 3, 3, 3, 2,
        1, 3, 2, 1, 3, 2, 2, 3, 3, 1, 3, 1, 3, 2, 1, 3, 1, 3, 2, 1,
        2, 3, 1, 1, 2, 2, 3, 2, 2, 2, 2, 2, 3, 1, 3, 1, 1, 2, 3, 1,
        2, 2, 1, 1, 3, 2, 2, 1, 3, 3, 2, 2, 1, 1, 1, 1, 2, 1, 2, 11],

        [12, 13, 13, 14, 14, 14, 13, 13, 13, 13, 14, 14, 14, 14, 14, 13, 13, 13, 14, 13,
        14, 13, 14, 13, 14, 13, 14, 13, 13, 13, 13, 14, 14, 14, 14, 13, 14, 13, 13, 13,
        13, 14, 13, 14, 14, 13, 13, 13, 14, 14, 14, 13, 14, 14, 13, 13, 14, 14, 14, 13,
        13, 13, 13, 14, 14, 14, 14, 13, 13, 14, 13, 14, 14, 14, 13, 13, 13, 13, 14, 15]
      ],

    "detail": [
      [-1, -1, -1, -1, -1, -1, -1, -1, -1, -1, -1, -1, -1, -1, -1, -1, -1, -1, -1, -1, -1, -1, -1, -1, -1, -1, -1, -1, -1, -1, -1, -1, -1, -1, -1, -1, -1, -1, -1, -1, -1, -1, -1, -1, -1, -1, -1, -1, -1, -1, -1, -1, -1, -1, -1, -1, -1, -1, -1, -1, -1, -1, -1, -1, -1, -1, -1, -1, -1, -1, -1, -1, -1, -1, -1, -1, -1, -1, -1, -1],
      [-1, -1, -1, -1, -1, -1, -1, -1, -1, -1, -1, -1, -1, -1, -1, -1, -1, -1, -1, -1, -1, -1, -1, -1, -1, -1, -1, -1, -1, -1, -1, -1, -1, -1, -1, -1, -1, -1, -1, -1, -1, -1, -1, -1, -1, -1, -1, -1, -1, -1, -1, -1, -1, -1, -1, -1, -1, -1, -1, -1, -1, -1, -1, -1, -1, -1, -1, -1, -1, -1, -1, -1, -1, -1, -1, -1, -1, -1, -1, -1],
      [-1, -1, -1, -1, -1, -1, -1, -1, -1, -1, -1, -1, -1, -1, -1, -1, -1, -1, -1, -1, -1, -1, -1, -1, -1, -1, -1, -1, -1, -1, -1, -1, -1, -1, -1, -1, -1, -1, -1, -1, -1, -1, -1, -1, -1, -1, -1, -1, -1, -1, -1, -1, -1, -1, -1, -1, -1, -1, -1, -1, -1, -1, -1, -1, -1, -1, -1, -1, -1, -1, -1, -1, -1, -1, -1, -1, -1, -1, -1, -1],
      [-1, -1, -1, -1, -1, -1, -1, -1, -1, -1, -1, -1, -1, -1, -1, -1, -1, -1, -1, -1, -1, -1, -1, -1, -1, -1, -1, -1, -1, -1, -1, -1, -1, -1, -1, -1, -1, -1, -1, -1, -1, -1, -1, -1, -1, -1, -1, -1, -1, -1, -1, -1, -1, -1, -1, -1, -1, -1, -1, -1, -1, -1, -1, -1, -1, -1, -1, -1, -1, -1, -1, -1, -1, -1, -1, -1, -1, -1, -1, -1],
      [-1, -1, -1, -1, -1, -1, -1, -1, -1, -1, -1, -1, -1, -1, -1, -1, -1, -1, -1, -1, -1, -1, -1, -1, -1, -1, -1, -1, -1, -1, -1, -1, -1, -1, -1, -1, -1, -1, -1, -1, -1, -1, -1, -1, -1, -1, -1, -1, -1, -1, -1, -1, -1, -1, -1, -1, -1, -1, -1, -1, -1, -1, -1, -1, -1, -1, -1, -1, -1, -1, -1, -1, -1, -1, -1, -1, -1, -1, -1, -1],
      [-1, -1, -1, -1, -1, -1, -1, -1, -1, -1, -1, -1, -1, -1, -1, -1, -1, -1, -1, -1, -1, -1, -1, -1, -1, -1, -1, -1, -1, -1, -1, -1, -1, -1, -1, -1, -1, -1, -1, -1, -1, -1, -1, -1, -1, -1, -1, -1, -1, -1, -1, -1, -1, -1, -1, -1, -1, -1, -1, -1, -1, -1, -1, -1, -1, -1, -1, -1, -1, -1, -1, -1, -1, -1, -1, -1, -1, -1, -1, -1],
      [-1, -1, -1, -1, -1, -1, -1, -1, -1, -1, -1, -1, -1, -1, -1, -1, -1, -1, -1, -1, -1, -1, -1, -1, -1, -1, -1, -1, -1, -1, -1, -1, -1, -1, -1, -1, -1, -1, -1, -1, -1, -1, -1, -1, -1, -1, -1, -1, -1, -1, -1, -1, -1, -1, -1, -1, -1, -1, -1, -1, -1, -1, -1, -1, -1, -1, -1, -1, -1, -1, -1, -1, -1, -1, -1, -1, -1, -1, -1, -1],
      [-1, -1, -1, -1, -1, -1, -1, -1, -1, -1, -1, -1, -1, -1, -1, -1, -1, -1, -1, -1, -1, -1, -1, -1, -1, -1, -1, -1, -1, -1, -1, -1, -1, -1, -1, -1, -1, -1, -1, -1, -1, -1, -1, -1, -1, -1, -1, -1, -1, -1, -1, -1, -1, -1, -1, -1, -1, -1, -1, -1, -1, -1, -1, -1, -1, -1, -1, -1, -1, -1, -1, -1, -1, -1, -1, -1, -1, -1, -1, -1],
      [-1, -1, -1, -1, -1, -1, -1, -1, -1, -1, -1, -1, -1, -1, -1, -1, -1, -1, -1, -1, -1, -1, -1, -1, -1, -1, -1, -1, -1, -1, -1, -1, -1, -1, -1, -1, -1, -1, -1, -1, -1, -1, -1, -1, -1, -1, -1, -1, -1, -1, -1, -1, -1, -1, -1, -1, -1, -1, -1, -1, -1, -1, -1, -1, -1, -1, -1, -1, -1, -1, -1, -1, -1, -1, -1, -1, -1, -1, -1, -1],
      [-1, -1, -1, -1, -1, -1, -1, -1, -1, -1, -1, -1, -1, -1, -1, -1, -1, -1, -1, -1, -1, -1, -1, -1, -1, -1, -1, -1, -1, -1, -1, -1, -1, -1, -1, -1, -1, -1, -1, -1, -1, -1, -1, -1, -1, -1, -1, -1, -1, -1, -1, -1, -1, -1, -1, -1, -1, -1, -1, -1, -1, -1, -1, -1, -1, -1, -1, -1, -1, -1, -1, -1, -1, -1, -1, -1, -1, -1, -1, -1],
      [-1, -1, -1, -1, -1, -1, -1, -1, -1, -1, -1, -1, -1, -1, -1, -1, -1, -1, -1, -1, -1, -1, -1, -1, -1, -1, -1, -1, -1, -1, -1, -1, -1, -1, -1, -1, -1, -1, -1, -1, -1, -1, -1, -1, -1, -1, -1, -1, -1, -1, -1, -1, -1, -1, -1, -1, -1, -1, -1, -1, -1, -1, -1, -1, -1, -1, -1, -1, -1, -1, -1, -1, -1, -1, -1, -1, -1, -1, -1, -1],
      [-1, -1, -1, -1, -1, -1, -1, -1, -1, -1, -1, -1, -1, -1, -1, -1, -1, -1, -1, -1, -1, -1, -1, -1, -1, -1, -1, -1, -1, -1, -1, -1, -1, -1, -1, -1, -1, -1, -1, -1, -1, -1, -1, -1, -1, -1, -1, -1, -1, -1, -1, -1, -1, -1, -1, -1, -1, -1, -1, -1, -1, -1, -1, -1, -1, -1, -1, -1, -1, -1, -1, -1, -1, -1, -1, -1, -1, -1, -1, -1],
      [-1, -1, -1, -1, -1, -1, -1, -1, -1, -1, -1, 19, 19, -1, -1, -1, -1, -1, -1, -1, -1, -1, -1, -1, -1, -1, -1, -1, -1, -1, -1, -1, -1, -1, -1, -1, -1, -1, -1, -1, -1, -1, -1, -1, -1, -1, -1, -1, -1, -1, -1, -1, -1, -1, -1, -1, -1, -1, -1, -1, -1, -1, -1, -1, -1, -1, -1, -1, -1, -1, -1, -1, -1, -1, -1, -1, -1, -1, -1, -1],
      [-1, -1, -1, -1, -1, -1, -1, -1, -1, -1, -1, 19, 19, -1, -1, -1, -1, -1, -1, -1, -1, -1, -1, -1, -1, -1, -1, -1, -1, -1, -1, -1, -1, -1, -1, -1, -1, -1, -1, -1, -1, -1, -1, -1, -1, -1, -1, -1, -1, -1, -1, -1, -1, -1, -1, -1, -1, -1, -1, -1, -1, -1, -1, -1, -1, -1, -1, -1, -1, -1, -1, -1, -1, -1, -1, -1, -1, -1, -1, -1],
      [-1, -1, -1, -1, -1, -1, -1, -1, -1, -1, -1, 19, 19, 19, -1, -1, -1, -1, -1, -1, -1, -1, -1, -1, -1, -1, -1, -1, -1, -1, -1, -1, -1, -1, -1, -1, -1, -1, -1, -1, -1, -1, -1, -1, -1, -1, -1, -1, -1, -1, -1, -1, -1, -1, -1, -1, -1, -1, -1, -1, -1, -1, -1, -1, -1, -1, -1, -1, -1, -1, -1, -1, -1, -1, -1, -1, -1, -1, -1, -1],
      [-1, -1, -1, -1, -1, -1, -1, -1, -1, -1, -1, 18, 18, 18, -1, -1, -1, -1, -1, -1, -1, -1, -1, -1, -1, -1, -1, -1, -1, -1, -1, -1, -1, -1, -1, -1, -1, -1, -1, -1, -1, -1, -1, -1, -1, -1, -1, -1, -1, -1, -1, -1, -1, -1, -1, -1, -1, -1, -1, -1, -1, -1, -1, -1, -1, -1, -1, -1, -1, -1, -1, -1, -1, -1, -1, -1, -1, -1, -1, -1],
      [-1, -1, -1, -1, -1, -1, -1, -1, -1, -1, -1, 16, 16, 18, -1, -1, -1, -1, -1, -1, -1, -1, -1, -1, -1, -1, -1, -1, -1, -1, -1, -1, -1, -1, -1, -1, -1, -1, -1, -1, -1, -1, -1, -1, -1, -1, -1, -1, -1, -1, -1, -1, -1, -1, -1, -1, -1, -1, -1, -1, -1, -1, -1, -1, -1, -1, -1, -1, -1, -1, -1, -1, -1, -1, -1, -1, -1, -1, -1, -1],
      [-1, -1, -1, -1, -1, -1, -1, -1, -1, -1, -1, 16, 16, 18, -1, -1, -1, -1, -1, -1, -1, -1, -1, -1, -1, -1, -1, -1, -1, -1, -1, -1, -1, -1, -1, -1, -1, -1, -1, -1, -1, -1, -1, -1, -1, -1, -1, -1, -1, -1, -1, -1, -1, -1, -1, -1, -1, -1, -1, -1, -1, -1, -1, -1, -1, -1, -1, -1, -1, -1, -1, -1, -1, -1, -1, -1, -1, -1, -1, -1],
      [-1, -1, -1, -1, -1, -1, -1, -1, -1, -1, -1, 16, 18, 18, -1, -1, -1, -1, -1, -1, -1, -1, -1, -1, -1, -1, -1, 21, 21, 20, -1, -1, -1, -1, -1, -1, -1, -1, -1, -1, -1, -1, -1, -1, -1, -1, -1, -1, -1, -1, -1, -1, -1, -1, -1, -1, -1, -1, -1, -1, -1, -1, -1, -1, -1, -1, -1, -1, -1, -1, -1, -1, -1, -1, -1, -1, -1, -1, -1, -1],
      [-1, -1, -1, -1, -1, -1, -1, -1, -1, -1, -1, 16, 16, 18, -1, -1, -1, -1, -1, -1, -1, -1, -1, -1, -1, -1, 23, 21, 20, 23, 23, -1, -1, -1, -1, -1, -1, -1, -1, -1, -1, -1, -1, -1, -1, -1, -1, -1, -1, -1, -1, -1, -1, -1, -1, -1, -1, -1, -1, -1, -1, -1, -1, -1, -1, -1, -1, -1, -1, -1, -1, -1, -1, -1, -1, -1, -1, -1, -1, -1],
      [-1, -1, -1, -1, -1, -1, -1, -1, -1, -1, -1, 16, 16, 16, -1, -1, -1, -1, -1, -1, -1, -1, -1, -1, -1, 23, 20, 23, 23, 23, 20, 23, 23, -1, -1, -1, -1, -1, -1, -1, -1, -1, -1, -1, -1, -1, -1, -1, -1, -1, -1, -1, -1, -1, -1, -1, -1, -1, -1, -1, -1, -1, -1, -1, -1, -1, -1, -1, -1, -1, -1, -1, -1, -1, -1, -1, -1, -1, -1, -1]
    ],

    "decor": [
      [-1, -1, -1, -1, -1, -1, -1, -1, -1, -1, -1, -1, -1, -1, -1, -1, -1, -1, -1, -1, -1, -1, -1, -1, -1, -1, -1, -1, -1, -1, -1, -1, -1, -1, -1, -1, -1, -1, -1, -1, -1, -1, -1, -1, -1, -1, -1, -1, -1, -1, -1, -1, -1, -1, -1, -1, -1, -1, -1, -1, -1, -1, -1, -1, -1, -1, -1, -1, -1, -1, -1, -1, -1, -1, -1, -1, -1, -1, -1, -1],
      [-1, -1, -1, -1, -1, -1, -1, -1, -1, -1, -1, -1, -1, -1, -1, -1, -1, -1, -1, -1, -1, -1, -1, -1, -1, -1, -1, -1, -1, -1, -1, -1, -1, -1, -1, -1, -1, -1, -1, -1, -1, -1, -1, -1, -1, -1, -1, -1, -1, -1, -1, -1, -1, -1, -1, -1, -1, -1, -1, -1, -1, -1, -1, -1, -1, -1, -1, -1, -1, -1, -1, -1, -1, -1, -1, -1, -1, -1, -1, -1],
      [-1, -1, -1, -1, -1, -1, -1, -1, -1, -1, -1, -1, -1, -1, -1, -1, -1, -1, -1, -1, -1, -1, -1, -1, -1, -1, -1, -1, -1, -1, -1, -1, -1, -1, -1, -1, -1, -1, -1, -1, -1, -1, -1, -1, -1, -1, -1, -1, -1, -1, -1, -1, -1, -1, -1, -1, -1, -1, -1, -1, -1, -1, -1, -1, -1, -1, -1, -1, -1, -1, -1, -1, -1, -1, -1, -1, -1, -1, -1, -1],
      [-1, -1, -1, -1, -1, -1, -1, -1, -1, -1, -1, -1, -1, -1, -1, -1, -1, -1, -1, -1, -1, -1, -1, -1, -1, -1, -1, -1, -1, -1, -1, -1, -1, -1, -1, -1, -1, -1, -1, -1, -1, -1, -1, -1, -1, -1, -1, -1, -1, -1, -1, -1, -1, -1, -1, -1, -1, -1, -1, -1, -1, -1, -1, -1, -1, -1, -1, -1, -1, -1, -1, -1, -1, -1, -1, -1, -1, -1, -1, -1],
      [-1, -1, -1, -1, -1, -1, -1, -1, -1, -1, -1, -1, -1, -1, -1, -1, -1, -1, -1, -1, -1, -1, -1, -1, -1, -1, -1, -1, -1, -1, -1, -1, -1, -1, -1, -1, -1, -1, -1, -1, -1, -1, -1, -1, -1, -1, -1, -1, -1, -1, -1, -1, -1, -1, -1, -1, -1, -1, -1, -1, -1, -1, -1, -1, -1, -1, -1, -1, -1, -1, -1, -1, -1, -1, -1, -1, -1, -1, -1, -1],
      [-1, -1, -1, -1, -1, -1, -1, -1, -1, -1, -1, -1, -1, -1, -1, -1, -1, -1, -1, -1, -1, -1, -1, -1, -1, -1, -1, -1, -1, -1, -1, -1, -1, -1, -1, -1, -1, -1, -1, -1, -1, -1, -1, -1, -1, -1, -1, -1, -1, -1, -1, -1, -1, -1, -1, -1, -1, -1, -1, -1, -1, -1, -1, -1, -1, -1, -1, -1, -1, -1, -1, -1, -1, -1, -1, -1, -1, -1, -1, -1],
      [-1, -1, -1, -1, -1, -1, -1, -1, -1, -1, -1, -1, -1, -1, -1, -1, -1, -1, -1, -1, -1, -1, -1, -1, -1, -1, -1, -1, -1, -1, -1, -1, -1, -1, -1, -1, -1, -1, -1, -1, -1, -1, -1, -1, -1, -1, -1, -1, -1, -1, -1, -1, -1, -1, -1, -1, -1, -1, -1, -1, -1, -1, -1, -1, -1, -1, -1, -1, -1, -1, -1, -1, -1, -1, -1, -1, -1, -1, -1, -1],
      [-1, -1, -1, -1, -1, -1, -1, -1, -1, -1, -1, -1, -1, -1, -1, -1, -1, -1, -1, -1, -1, -1, -1, -1, -1, -1, -1, -1, -1, -1, -1, -1, -1, -1, -1, -1, -1, -1, -1, -1, -1, -1, -1, -1, -1, -1, -1, -1, -1, -1, -1, -1, -1, -1, -1, -1, -1, -1, -1, -1, -1, -1, -1, -1, -1, -1, -1, -1, -1, -1, -1, -1, -1, -1, -1, -1, -1, -1, -1, -1],
      [-1, -1, -1, -1, -1, -1, -1, -1, -1, -1, -1, -1, -1, -1, -1, -1, -1, -1, -1, -1, -1, -1, -1, -1, -1, -1, -1, -1, -1, -1, -1, -1, -1, -1, -1, -1, -1, -1, -1, -1, -1, -1, -1, -1, -1, -1, -1, -1, -1, -1, -1, -1, -1, -1, -1, -1, -1, -1, -1, -1, -1, -1, -1, -1, -1, -1, -1, -1, -1, -1, -1, -1, -1, -1, -1, -1, -1, -1, -1, -1],
      [-1, -1, -1, -1, -1, -1, -1, -1, -1, -1, -1, -1, -1, -1, -1, -1, -1, -1, -1, -1, -1, -1, -1, -1, -1, -1, -1, -1, -1, -1, -1, -1, -1, -1, -1, -1, -1, -1, -1, -1, -1, -1, -1, -1, -1, -1, -1, -1, -1, -1, -1, -1, -1, -1, -1, -1, -1, -1, -1, -1, -1, -1, -1, -1, -1, -1, -1, -1, -1, -1, -1, -1, -1, -1, -1, -1, -1, -1, -1, -1],
      [-1, -1, -1, -1, -1, -1, -1, -1, -1, -1, -1, -1, -1, -1, -1, -1, -1, -1, -1, -1, -1, -1, -1, -1, -1, -1, -1, -1, -1, -1, -1, -1, -1, -1, -1, -1, -1, -1, -1, -1, -1, -1, -1, -1, -1, -1, -1, -1, -1, -1, -1, -1, -1, -1, -1, -1, -1, -1, -1, -1, -1, -1, -1, -1, -1, -1, -1, -1, -1, -1, -1, -1, -1, -1, -1, -1, -1, -1, -1, -1],
      [-1, -1, -1, -1, -1, -1, -1, -1, -1, -1, -1, -1, -1, -1, -1, -1, -1, -1, -1, -1, -1, -1, -1, -1, -1, -1, -1, -1, -1, -1, -1, -1, -1, -1, -1, -1, -1, -1, -1, -1, -1, -1, -1, -1, -1, -1, -1, -1, -1, -1, -1, -1, -1, -1, -1, -1, -1, -1, -1, -1, -1, -1, -1, -1, -1, -1, -1, -1, -1, -1, -1, -1, -1, -1, -1, -1, -1, -1, -1, -1],
      [-1, -1, -1, -1, -1, -1, -1, -1, -1, -1, -1, -1, -1, -1, -1, -1, -1, -1, -1, -1, -1, -1, -1, -1, -1, -1, -1, -1, -1, -1, -1, -1, -1, -1, -1, -1, -1, -1, -1, -1, -1, -1, -1, -1, -1, -1, -1, -1, -1, -1, -1, -1, -1, -1, -1, -1, -1, -1, -1, -1, -1, -1, -1, -1, -1, -1, -1, -1, -1, -1, -1, -1, -1, -1, -1, -1, -1, -1, -1, -1],
      [-1, -1, -1, -1, -1, -1, -1, -1, -1, -1, -1, -1, -1, -1, -1, -1, -1, -1, -1, -1, -1, -1, -1, -1, -1, -1, -1, -1, -1, -1, -1, -1, -1, -1, -1, -1, -1, -1, -1, -1, -1, -1, -1, -1, -1, -1, -1, -1, -1, -1, -1, -1, -1, -1, -1, -1, -1, -1, -1, -1, -1, -1, -1, -1, -1, -1, -1, -1, -1, -1, -1, -1, -1, -1, -1, -1, -1, -1, -1, -1],
      [-1, -1, -1, -1, -1, -1, -1, -1, -1, -1, -1, -1, -1, -1, -1, -1, -1, -1, -1, -1, -1, -1, -1, -1, -1, -1, -1, -1, -1, -1, -1, -1, -1, -1, -1, -1, -1, -1, -1, -1, -1, -1, -1, -1, -1, -1, -1, -1, -1, -1, -1, -1, -1, -1, -1, -1, -1, -1, -1, -1, -1, -1, -1, -1, -1, -1, -1, -1, -1, -1, -1, -1, -1, -1, -1, -1, -1, -1, -1, -1],
      [-1, -1, -1, -1, -1, -1, -1, -1, -1, -1, -1, -1, -1, -1, -1, -1, -1, -1, -1, -1, -1, -1, -1, -1, -1, -1, -1, -1, -1, -1, -1, -1, -1, -1, -1, -1, -1, -1, -1, -1, -1, -1, -1, -1, -1, -1, -1, -1, -1, -1, -1, -1, -1, -1, -1, -1, -1, -1, -1, -1, -1, -1, -1, -1, -1, -1, -1, -1, -1, -1, -1, -1, -1, -1, -1, -1, -1, -1, -1, -1],
      [-1, -1, -1, -1, -1, -1, -1, -1, -1, -1, -1, -1, -1, -1, -1, -1, -1, -1, -1, -1, -1, -1, -1, -1, -1, -1, -1, -1, -1, -1, -1, -1, -1, -1, -1, -1, -1, -1, -1, -1, -1, -1, -1, -1, -1, -1, -1, -1, -1, -1, -1, -1, -1, -1, -1, -1, -1, -1, -1, -1, -1, -1, -1, -1, -1, -1, -1, -1, -1, -1, -1, -1, -1, -1, -1, -1, -1, -1, -1, -1],
      [-1, -1, -1, -1, -1, -1, -1, -1, -1, -1, -1, -1, -1, -1, -1, -1, -1, -1, -1, -1, -1, -1, -1, -1, -1, -1, -1, -1, -1, -1, -1, -1, -1, -1, -1, -1, -1, -1, -1, -1, -1, -1, -1, -1, -1, -1, -1, -1, -1, -1, -1, -1, -1, -1, -1, -1, -1, -1, -1, -1, -1, -1, -1, -1, -1, -1, -1, -1, -1, -1, -1, -1, -1, -1, -1, -1, -1, -1, -1, -1],
      [-1, -1, -1, -1, -1, -1, -1, -1, -1, -1, -1, -1, -1, -1, -1, -1, -1, -1, -1, -1, -1, -1, -1, -1, -1, -1, -1, -1, -1, -1, -1, -1, -1, -1, -1, -1, -1, -1, -1, -1, -1, -1, -1, -1, -1, -1, -1, -1, -1, -1, -1, -1, -1, -1, -1, -1, -1, -1, -1, -1, -1, -1, -1, -1, -1, -1, -1, -1, -1, -1, -1, -1, -1, -1, -1, -1, -1, -1, -1, -1],
      [-1, -1, -1, -1, -1, -1, -1, -1, -1, -1, -1, -1, -1, -1, -1, -1, -1, -1, -1, -1, -1, -1, -1, -1, -1, -1, -1, -1, -1, -1, -1, -1, -1, -1, -1, -1, -1, -1, -1, -1, -1, -1, -1, -1, -1, -1, -1, -1, -1, -1, -1, -1, -1, -1, -1, -1, -1, -1, -1, -1, -1, -1, -1, -1, -1, -1, -1, -1, -1, -1, -1, -1, -1, -1, -1, -1, -1, -1, -1, -1],
      [-1, -1, -1, -1, -1, -1, -1, -1, -1, -1, -1, -1, -1, -1, -1, -1, -1, -1, -1, -1, -1, -1, -1, -1, -1, -1, -1, -1, -1, -1, -1, -1, -1, -1, -1, -1, -1, -1, -1, -1, -1, -1, -1, -1, -1, -1, -1, -1, -1, -1, -1, -1, -1, -1, -1, -1, -1, -1, -1, -1, -1, -1, -1, -1, -1, -1, -1, -1, -1, -1, -1, -1, -1, -1, -1, -1, -1, -1, -1, -1]
    ],

    "collision": [
      [1, 1, 1, 1, 1, 1, 1, 1, 1, 1, 1, 1, 1, 1, 1, 1, 1, 1, 1, 1, 1, 1, 1, 1, 1, 1, 1, 1, 1, 1, 1, 1, 1, 1, 1, 1, 1, 1, 1, 1, 1, 1, 1, 1, 1, 1, 1, 1, 1, 1, 1, 1, 1, 1, 1, 1, 1, 1, 1, 1, 1, 1, 1, 1, 1, 1, 1, 1, 1, 1, 1, 1, 1, 1, 1, 1, 1, 1, 1, 1],
      [1, 0, 0, 0, 0, 0, 0, 0, 0, 0, 0, 0, 0, 0, 0, 0, 0, 0, 0, 0, 0, 0, 0, 0, 0, 0, 0, 0, 0, 0, 0, 0, 0, 0, 0, 0, 0, 0, 0, 0, 0, 0, 0, 0, 0, 0, 0, 0, 0, 0, 0, 0, 0, 0, 0, 0, 0, 0, 0, 0, 0, 0, 0, 0, 0, 0, 0, 0, 0, 0, 0, 0, 0, 0, 0, 0, 0, 0, 0, 1],
      [1, 0, 0, 0, 0, 0, 0, 0, 0, 0, 0, 0, 0, 0, 0, 0, 0, 0, 0, 0, 0, 0, 0, 0, 0, 0, 0, 0, 0, 0, 0, 0, 0, 0, 0, 0, 0, 0, 0, 0, 0, 0, 0, 0, 0, 0, 0, 0, 0, 0, 0, 0, 0, 0, 0, 0, 0, 0, 0, 0, 0, 0, 0, 0, 0, 0, 0, 0, 0, 0, 0, 0, 0, 0, 0, 0, 0, 0, 0, 1],
      [1, 0, 0, 0, 0, 0, 0, 0, 0, 0, 0, 0, 0, 0, 0, 0, 0, 0, 0, 0, 0, 0, 0, 0, 0, 0, 0, 0, 0, 0, 0, 0, 0, 0, 0, 0, 0, 0, 0, 0, 0, 0, 0, 0, 0, 0, 0, 0, 0, 0, 0, 0, 0, 0, 0, 0, 0, 0, 0, 0, 0, 0, 0, 0, 0, 0, 0, 0, 0, 0, 0, 0, 0, 0, 0, 0, 0, 0, 0, 1],
      [1, 1, 0, 0, 0, 0, 0, 0, 0, 0, 0, 0, 0, 0, 0, 0, 0, 0, 0, 0, 0, 0, 0, 0, 0, 0, 0, 0, 0, 0, 0, 0, 0, 0, 0, 0, 0, 0, 0, 0, 0, 0, 0, 0, 0, 0, 0, 0, 0, 0, 0, 0, 0, 0, 0, 0, 0, 0, 0, 0, 0, 0, 0, 0, 0, 0, 0, 0, 0, 0, 0, 0, 0, 0, 0, 0, 0, 0, 0, 1],
      [1, 1, 0, 0, 0, 0, 0, 0, 0, 0, 0, 0, 0, 0, 0, 0, 0, 0, 0, 0, 0, 0, 0, 0, 0, 0, 0, 0, 0, 0, 0, 0, 0, 0, 0, 0, 0, 0, 0, 0, 0, 0, 0, 0, 0, 0, 0, 0, 0, 0, 0, 0, 0, 0, 0, 0, 0, 0, 0, 0, 0, 0, 0, 0, 0, 0, 0, 0, 0, 0, 0, 0, 0, 0, 0, 0, 0, 0, 0, 1],
      [1, 1, 0, 0, 0, 0, 0, 0, 0, 0, 0, 0, 0, 0, 0, 0, 0, 0, 0, 0, 0, 0, 0, 0, 0, 0, 0, 0, 0, 0, 0, 0, 0, 0, 0, 0, 0, 0, 0, 0, 0, 0, 0, 0, 0, 0, 0, 0, 0, 0, 0, 0, 0, 0, 0, 0, 0, 0, 0, 0, 0, 0, 0, 0, 0, 0, 0, 0, 0, 0, 0, 0, 0, 0, 0, 0, 0, 0, 0, 1],
      [1, 1, 1, 0, 0, 0, 0, 0, 0, 0, 0, 0, 0, 0, 0, 0, 0, 0, 0, 0, 0, 0, 0, 0, 0, 0, 0, 0, 0, 0, 0, 0, 0, 0, 0, 0, 0, 0, 0, 0, 0, 0, 0, 0, 0, 0, 0, 0, 0, 0, 0, 0, 0, 0, 0, 0, 0, 0, 0, 0, 0, 0, 0, 0, 0, 0, 0, 0, 0, 0, 0, 0, 0, 0, 0, 0, 0, 0, 0, 1],
      [1, 0, 0, 0, 0, 0, 0, 0, 0, 0, 0, 0, 0, 0, 0, 0, 0, 0, 0, 0, 0, 0, 0, 0, 0, 0, 0, 0, 0, 0, 0, 0, 0, 0, 0, 0, 0, 0, 0, 0, 0, 0, 0, 0, 0, 0, 0, 0, 0, 0, 0, 0, 0, 0, 0, 0, 0, 0, 0, 0, 0, 0, 0, 0, 0, 0, 0, 0, 0, 0, 0, 0, 0, 0, 0, 0, 0, 0, 0, 1],
      [1, 0, 0, 0, 0, 0, 0, 0, 0, 0, 0, 0, 0, 0, 0, 0, 0, 0, 0, 0, 0, 0, 0, 0, 0, 0, 0, 0, 0, 0, 0, 0, 0, 0, 0, 0, 0, 0, 0, 0, 0, 0, 0, 0, 0, 0, 0, 0, 0, 0, 0, 0, 0, 0, 0, 0, 0, 0, 0, 0, 0, 0, 0, 0, 0, 0, 0, 0, 0, 0, 0, 0, 0, 0, 0, 0, 0, 0, 0, 1],
      [1, 0, 0, 0, 0, 0, 0, 0, 0, 0, 0, 0, 0, 0, 0, 0, 0, 0, 0, 0, 0, 0, 0, 0, 0, 0, 0, 0, 0, 0, 0, 0, 0, 0, 0, 0, 0, 0, 0, 0, 0, 0, 0, 0, 0, 0, 0, 0, 0, 0, 0, 0, 0, 0, 0, 0, 0, 0, 0, 0, 0, 0, 0, 0, 0, 0, 0, 0, 0, 0, 0, 0, 0, 0, 0, 0, 0, 0, 0, 1],
      [1, 0, 0, 0, 0, 0, 0, 0, 0, 0, 0, 0, 0, 0, 0, 0, 0, 0, 0, 0, 0, 0, 0, 0, 0, 0, 0, 0, 0, 0, 0, 0, 0, 0, 0, 0, 0, 0, 0, 0, 0, 0, 0, 0, 0, 0, 0, 0, 0, 0, 0, 0, 0, 0, 0, 0, 0, 0, 0, 0, 0, 0, 0, 0, 0, 0, 0, 0, 0, 0, 0, 0, 0, 0, 0, 0, 0, 0, 0, 1],
      [1, 0, 0, 0, 0, 0, 0, 0, 0, 0, 0, 2, 3, 0, 0, 0, 0, 0, 0, 0, 0, 0, 0, 0, 0, 0, 0, 0, 0, 0, 0, 0, 0, 0, 0, 0, 0, 0, 0, 0, 0, 0, 0, 0, 0, 0, 0, 0, 0, 0, 0, 0, 0, 0, 0, 0, 0, 0, 0, 0, 0, 0, 0, 0, 0, 0, 0, 0, 0, 0, 0, 0, 0, 0, 0, 0, 0, 0, 0, 1],
      [1, 0, 0, 0, 0, 0, 0, 0, 0, 0, 0, 2, 3, 0, 0, 0, 0, 0, 0, 0, 0, 0, 0, 0, 0, 0, 0, 0, 0, 0, 0, 0, 0, 0, 0, 0, 0, 0, 0, 0, 0, 0, 0, 0, 0, 0, 0, 0, 0, 0, 0, 0, 0, 0, 0, 0, 0, 0, 0, 0, 0, 0, 0, 0, 0, 0, 0, 0, 0, 0, 0, 0, 0, 0, 0, 0, 0, 0, 0, 1],
      [1, 0, 0, 0, 0, 0, 0, 0, 0, 0, 0, 2, 3, 3, 0, 0, 0, 0, 0, 0, 0, 0, 0, 0, 0, 0, 0, 0, 0, 0, 0, 0, 0, 0, 0, 0, 0, 0, 0, 0, 0, 0, 0, 0, 0, 0, 0, 0, 0, 0, 0, 0, 0, 0, 0, 0, 0, 0, 0, 0, 0, 0, 0, 0, 0, 0, 0, 0, 0, 0, 0, 0, 0, 0, 0, 0, 0, 0, 0, 1],
      [1, 0, 0, 0, 0, 0, 0, 0, 0, 0, 0, 2, 3, 3, 0, 0, 0, 0, 0, 0, 0, 0, 0, 0, 0, 0, 0, 0, 0, 0, 0, 0, 0, 0, 0, 0, 0, 0, 0, 0, 0, 0, 0, 0, 0, 0, 0, 0, 0, 0, 0, 0, 0, 0, 0, 0, 0, 0, 0, 0, 0, 0, 0, 0, 0, 0, 0, 0, 0, 0, 0, 0, 0, 0, 0, 0, 0, 0, 0, 1],
      [1, 0, 0, 0, 0, 0, 0, 0, 0, 0, 0, 2, 3, 2, 0, 0, 0, 0, 0, 0, 0, 0, 0, 0, 0, 0, 0, 0, 0, 0, 0, 0, 0, 0, 0, 0, 0, 0, 0, 0, 0, 0, 0, 0, 0, 0, 0, 0, 0, 0, 0, 0, 0, 0, 0, 0, 0, 0, 0, 0, 0, 0, 0, 0, 0, 0, 0, 0, 0, 0, 0, 0, 0, 0, 0, 0, 0, 0, 0, 1],
      [1, 0, 0, 0, 0, 0, 0, 0, 0, 0, 0, 2, 3, 3, 0, 0, 0, 0, 0, 0, 0, 0, 0, 0, 0, 0, 0, 1, 1, 0, 0, 0, 0, 0, 0, 0, 0, 0, 0, 0, 0, 0, 0, 0, 0, 0, 0, 0, 0, 0, 0, 0, 0, 0, 0, 0, 0, 0, 0, 0, 0, 0, 0, 0, 0, 0, 0, 0, 0, 0, 0, 0, 0, 0, 0, 0, 0, 0, 0, 1],
      [1, 0, 0, 0, 0, 0, 0, 0, 0, 0, 0, 2, 3, 3, 0, 0, 0, 0, 0, 0, 0, 0, 0, 0, 0, 0, 0, 1, 1, 1, 0, 0, 0, 0, 0, 0, 0, 0, 0, 0, 0, 0, 0, 0, 0, 0, 0, 0, 0, 0, 0, 0, 0, 0, 0, 0, 0, 0, 0, 0, 0, 0, 0, 0, 0, 0, 0, 0, 0, 0, 0, 0, 0, 0, 0, 0, 0, 0, 0, 1],
      [1, 0, 0, 0, 0, 0, 0, 0, 0, 0, 0, 2, 3, 2, 0, 0, 0, 0, 0, 0, 0, 0, 0, 0, 0, 0, 1, 1, 1, 1, 1, 0, 0, 0, 0, 0, 0, 0, 0, 0, 0, 0, 0, 0, 0, 0, 0, 0, 0, 0, 0, 0, 0, 0, 0, 0, 0, 0, 0, 0, 0, 0, 0, 0, 0, 0, 0, 0, 0, 0, 0, 0, 0, 0, 0, 0, 0, 0, 0, 1],
      [1, 1, 1, 1, 1, 1, 1, 1, 1, 1, 1, 1, 1, 1, 1, 1, 1, 1, 1, 1, 1, 1, 1, 1, 1, 1, 1, 1, 1, 1, 1, 1, 1, 1, 1, 1, 1, 1, 1, 1, 1, 1, 1, 1, 1, 1, 1, 1, 1, 1, 1, 1, 1, 1, 1, 1, 1, 1, 1, 1, 1, 1, 1, 1, 1, 1, 1, 1, 1, 1, 1, 1, 1, 1, 1, 1, 1, 1, 1, 1]
    ]
  },
  "player_spawn": [
    176,
    176
  ],
  "enemy_spawns": [
    {
      "type": "slime_green",
      "pos": [400, 455],
      "spawn_time": 0
    },
    {
      "type": "goblin",
      "pos": [200, 355],
      "spawn_time": 10 
    },
    {
      "type": "goblin",
      "pos": [976, 592],
      "spawn_time": 10
    },
    {
      "type": "slime_green",
      "pos": [400, 455],
      "spawn_time": 15 
    },
    {
      "type": "goblin",
      "pos": [200, 355],
      "spawn_time": 15 
    },
    {
      "type": "slime_green",
      "pos": [800, 215],
      "spawn_time": 20 
    }
  ],
  "item_spawns": [
    {
      "item_id": "sword_all_direction",
      "pos": [496, 170],
      "amount": 1,
      "spawn_time": 0 
    },
    {
      "item_id": "bow_power_1",
      "pos": [576, 476], 
      "amount": 1,
      "spawn_time": 10
    },
    {
      "item_id"
      : "potion_small",
      "pos": [876, 276], 
      "amount": 1,
      "spawn_time": 20
    }
  ],
  "decor_spawns": [
    {
      "image": "images/decors/big_tree_01.png",
      "pos": [930, 550],
      "anchor": "midbottom",
      "scale": 2.5     
    },
    {
      "image": "images/decors/big_tree_02.png",
      "pos": [20, 240],
      "anchor": "midbottom",
      "scale": 2.2
    },
    {
      "image": "images/decors/wall/corner_top.png",
      "pos": [400,  40],
      "anchor": "midbottom",
      "scale": 1.0
    },
    {
      "image": "images/decors/wall/corner_left.png",
      "pos": [40,  300],
      "anchor": "midbottom",
      "scale": 1.0
    },
    {
      "image": "images/decors/wall/corner_top.png",
      "pos": [1550, 300],
      "anchor": "midbottom",
      "scale": 1.0
    },
    {
      "image": "images/decors/wall/side_b.png",
      "pos": [1700, 350],
      "anchor": "midbottom",
      "scale": 1.0
    },
    {
      "image": "images/decors/wall/side_b.png",
      "pos": [1800, 400],
      "anchor": "midbottom",
      "scale": 1.0
    },
    {
      "image": "images/decors/wall/side_b.png",
      "pos": [1900, 450],
      "anchor": "midbottom",
      "scale": 1.0
    },
    {
      "image": "images/decors/wall/side_b.png",
      "pos": [2000, 500],
      "anchor": "midbottom",
      "scale": 1.0
    },
    {
      "image": "images/decors/wall/side_b.png",
      "pos": [2100, 550],
      "anchor": "midbottom",
      "scale": 1.0
    },
    {
      "image": "images/decors/wall/side_b.png",
      "pos": [2200, 600],
      "anchor": "midbottom",
      "scale": 1.0
    },
    {
      "image": "images/decors/wall/corner_buttom.png",
      "pos": [2350, 650],
      "anchor": "midbottom",
      "scale": 1.0
    },
    {
      "image": "images/decors/wall/corner_right.png",
      "pos": [2500, 600],
      "anchor": "midbottom",
      "scale": 1.0
    },
    {
      "image": "images/decors/wall/corner_left.png",
      "pos": [2350, 550],
      "anchor": "midbottom",
      "scale": 1.0
    },
    {
      "image": "images/decors/wall/side_a.png",
      "pos": [1400, 350],
      "anchor": "midbottom",
      "scale": 1.0
    },
    {
      "image": "images/decors/wall/side_a.png",
      "pos": [1300, 400],
      "anchor": "midbottom",
      "scale": 1.0
    },
    {
      "image": "images/decors/wall/side_a.png",
      "pos": [1200, 450],
      "anchor": "midbottom",
      "scale": 1.0
    },
    {
      "image": "images/decors/wall/side_a.png",
      "pos": [1100, 500],
      "anchor": "midbottom",
      "scale": 1.0
    },
    {
      "image": "images/decors/wall/side_a.png",
      "pos": [1000, 550],
      "anchor": "midbottom",
      "scale": 1.0
    },
    {
      "image": "images/decors/wall/corner_buttom.png",
      "pos": [850,  600],
      "anchor": "midbottom",
      "scale": 1.0
    }

  ]
}